70000111000001110111
00000000300000600000
11111110011111111111
10000000060000300100
11111111100111666100
00000000003000000100
00030000000000001110
60000103333333000000
00000166666366666666
00030100011110003000
11111111103000000000
20000000000000000000
11111000111111111110
40000000000000000000
01111111111111111007

