70000000000000003000
00000000000000200000
00000000000000000004
20002000000000000000
00000000000000000000
00003000000030000000
00000000000000000000
00000001110000000000
00000060410000000000
00000001110000000033
00000000000000021011
00000000000000000004
00000000000000011111
66666000000000000006
61116000060000000602
